* ************
*            *
*            *
*            *
*            *
**************